S ./textures/barrel.xpm
	R 640 480


	NO ./textures/north.xpm  
           SO ./textures/south.xpm      
WE ./textures/west.xpm
EA 	./textures/east.xpm


		F	 220,100,0 		
   C 			  			225,30,0



111111111111111111111111
100100000000010000000001
100000000001010000000001
101101111111010000000001
100001222221010202020001
111111200001010000000001
100000200021010200020001
100100200020010000000001
101111220220110202020001
100011000000000000000001
101011010000000000000001
111000011111111111011111
100010110000000000000001
101010000000000000000001
101010000000000000000001
101000000000000000000001
111111111000000000000001
120200002000000000000001
120000202000000000000001
120200002000000000000001
12022222200000000N000001
120000000000000000000001
111111111000000000000001
111111111111111111111111