S ./textures/barrel.xpm

	NO ./textures/north.xpm  
           SO ./textures/south.xpm      
WE ./textures/west.xpm
EA 	./textures/east.xpm


		F	 155,142,24 		
   C 			  			100,200,200



        1111111111111111111111111
        1000000000110000000000001
        1011000001110000001000001
        1001000000000000000000001
111111111011000001110000000000001
100000000011011101110111111111111
11110111111111 11100000010001
11110111111111111101010010001
11000000110101011100000010001
10001000000000001100000000001
10000000000000001101010010001
11000001110101011111011110N0111
11110111 1110101 101111010001
11111111 1111111 111111111111
